"filename", "language", "HTML", "PHP", "XML", "JavaScript", "CSS", "comment", "blank", "total"
"c:\xampp_new\htdocs\www\blog-classic-fullwidth.html", "HTML", 862, 0, 0, 0, 0, 118, 177, 1157
"c:\xampp_new\htdocs\www\blog-classic-sidebar-left.html", "HTML", 1012, 0, 0, 0, 0, 129, 205, 1346
"c:\xampp_new\htdocs\www\blog-classic-sidebar-right.html", "HTML", 1012, 0, 0, 0, 0, 129, 204, 1345
"c:\xampp_new\htdocs\www\blog-columns-2col.html", "HTML", 1107, 0, 0, 0, 0, 120, 258, 1485
"c:\xampp_new\htdocs\www\blog-columns-3col.html", "HTML", 1058, 0, 0, 0, 0, 120, 268, 1446
"c:\xampp_new\htdocs\www\blog-columns-4col.html", "HTML", 1058, 0, 0, 0, 0, 120, 268, 1446
"c:\xampp_new\htdocs\www\blog-masonry-2col.html", "HTML", 1107, 0, 0, 0, 0, 120, 258, 1485
"c:\xampp_new\htdocs\www\blog-masonry-3col.html", "HTML", 1058, 0, 0, 0, 0, 120, 268, 1446
"c:\xampp_new\htdocs\www\blog-masonry-4col.html", "HTML", 1058, 0, 0, 0, 0, 120, 268, 1446
"c:\xampp_new\htdocs\www\blog-single-fullwidth.html", "HTML", 873, 0, 0, 0, 0, 105, 204, 1182
"c:\xampp_new\htdocs\www\blog-single-sidebar-left.html", "HTML", 1028, 0, 0, 0, 0, 121, 234, 1383
"c:\xampp_new\htdocs\www\blog-single-sidebar-right.html", "HTML", 1028, 0, 0, 0, 0, 121, 233, 1382
"c:\xampp_new\htdocs\www\contact_me.php", "PHP", 0, 52, 0, 0, 0, 6, 11, 69
"c:\xampp_new\htdocs\www\contact_me_smtp.php", "PHP", 0, 70, 0, 0, 0, 5, 23, 98
"c:\xampp_new\htdocs\www\contact_reservations.php", "PHP", 0, 47, 0, 0, 0, 6, 12, 65
"c:\xampp_new\htdocs\www\contact_reservations_smtp.php", "PHP", 0, 66, 0, 0, 0, 5, 22, 93
"c:\xampp_new\htdocs\www\css\YTPlayer.css", "CSS", 0, 0, 0, 0, 1, 0, 0, 1
"c:\xampp_new\htdocs\www\css\animate.min.css", "CSS", 0, 0, 0, 0, 2, 4, 0, 6
"c:\xampp_new\htdocs\www\css\bootstrap-rtl.min.css", "CSS", 0, 0, 0, 0, 1, 7, 1, 9
"c:\xampp_new\htdocs\www\css\bootstrap.min.css", "CSS", 0, 0, 0, 0, 2, 5, 0, 7
"c:\xampp_new\htdocs\www\css\et-line.css", "CSS", 0, 0, 0, 0, 334, 7, 3, 344
"c:\xampp_new\htdocs\www\css\font-awesome.min.css", "CSS", 0, 0, 0, 0, 1, 3, 1, 5
"c:\xampp_new\htdocs\www\css\magnific-popup.css", "CSS", 0, 0, 0, 0, 330, 6, 39, 375
"c:\xampp_new\htdocs\www\css\owl.carousel.css", "CSS", 0, 0, 0, 0, 208, 18, 9, 235
"c:\xampp_new\htdocs\www\css\owl.transitions.css", "CSS", 0, 0, 0, 0, 149, 10, 4, 163
"c:\xampp_new\htdocs\www\css\rev-slider.css", "CSS", 0, 0, 0, 0, 28, 15, 11, 54
"c:\xampp_new\htdocs\www\css\simpletextrotator.css", "CSS", 0, 0, 0, 0, 92, 0, 14, 106
"c:\xampp_new\htdocs\www\css\style-responsive.css", "CSS", 0, 0, 0, 0, 691, 46, 135, 872
"c:\xampp_new\htdocs\www\css\style.css", "CSS", 0, 0, 0, 0, 5656, 330, 638, 6624
"c:\xampp_new\htdocs\www\css\vertical-rhythm.min.css", "CSS", 0, 0, 0, 0, 1, 0, 0, 1
"c:\xampp_new\htdocs\www\elements-accordions.html", "HTML", 767, 0, 0, 0, 0, 86, 150, 1003
"c:\xampp_new\htdocs\www\elements-bars.html", "HTML", 774, 0, 0, 0, 0, 104, 163, 1041
"c:\xampp_new\htdocs\www\elements-buttons.html", "HTML", 976, 0, 0, 0, 0, 112, 263, 1351
"c:\xampp_new\htdocs\www\elements-features.html", "HTML", 930, 0, 0, 0, 0, 132, 179, 1241
"c:\xampp_new\htdocs\www\elements-forms.html", "HTML", 879, 0, 0, 0, 0, 123, 212, 1214
"c:\xampp_new\htdocs\www\elements-grid.html", "HTML", 783, 0, 0, 0, 0, 98, 189, 1070
"c:\xampp_new\htdocs\www\elements-header-dark-transparent.html", "HTML", 733, 0, 0, 0, 0, 78, 141, 952
"c:\xampp_new\htdocs\www\elements-header-dark.html", "HTML", 729, 0, 0, 0, 0, 76, 139, 944
"c:\xampp_new\htdocs\www\elements-header-white-transparent.html", "HTML", 733, 0, 0, 0, 0, 78, 141, 952
"c:\xampp_new\htdocs\www\elements-header-white.html", "HTML", 729, 0, 0, 0, 0, 76, 139, 944
"c:\xampp_new\htdocs\www\elements-icons-et.html", "HTML", 844, 0, 0, 0, 0, 80, 150, 1074
"c:\xampp_new\htdocs\www\elements-icons-fe.html", "HTML", 2820, 0, 0, 0, 0, 80, 147, 3047
"c:\xampp_new\htdocs\www\elements-images-lazyload.html", "HTML", 740, 0, 0, 0, 0, 76, 139, 955
"c:\xampp_new\htdocs\www\elements-messages.html", "HTML", 757, 0, 0, 0, 0, 88, 160, 1005
"c:\xampp_new\htdocs\www\elements-page-titles.html", "HTML", 872, 0, 0, 0, 0, 94, 205, 1171
"c:\xampp_new\htdocs\www\elements-sliders-lazyload.html", "HTML", 793, 0, 0, 0, 0, 94, 171, 1058
"c:\xampp_new\htdocs\www\elements-sliders.html", "HTML", 1033, 0, 0, 0, 0, 148, 233, 1414
"c:\xampp_new\htdocs\www\elements-tabs.html", "HTML", 792, 0, 0, 0, 0, 96, 177, 1065
"c:\xampp_new\htdocs\www\elements-typography.html", "HTML", 842, 0, 0, 0, 0, 110, 206, 1158
"c:\xampp_new\htdocs\www\elements-video-sound.html", "HTML", 739, 0, 0, 0, 0, 86, 156, 981
"c:\xampp_new\htdocs\www\fonts\et-line.svg", "XML", 0, 0, 1214, 0, 0, 0, 0, 1214
"c:\xampp_new\htdocs\www\fonts\fontawesome-webfont.svg", "XML", 0, 0, 2671, 0, 0, 0, 1, 2672
"c:\xampp_new\htdocs\www\index-01.html", "HTML", 889, 0, 0, 0, 0, 139, 245, 1273
"c:\xampp_new\htdocs\www\index-02.html", "HTML", 889, 0, 0, 0, 0, 139, 245, 1273
"c:\xampp_new\htdocs\www\index-03.html", "HTML", 893, 0, 0, 0, 0, 139, 246, 1278
"c:\xampp_new\htdocs\www\index-04.html", "HTML", 893, 0, 0, 0, 0, 139, 246, 1278
"c:\xampp_new\htdocs\www\index-05.html", "HTML", 897, 0, 0, 0, 0, 139, 246, 1282
"c:\xampp_new\htdocs\www\index-06.html", "HTML", 893, 0, 0, 0, 0, 139, 246, 1278
"c:\xampp_new\htdocs\www\index-07.html", "HTML", 928, 0, 0, 0, 0, 147, 261, 1336
"c:\xampp_new\htdocs\www\index-08.html", "HTML", 928, 0, 0, 0, 0, 147, 261, 1336
"c:\xampp_new\htdocs\www\index-09.html", "HTML", 928, 0, 0, 0, 0, 147, 261, 1336
"c:\xampp_new\htdocs\www\index-10.html", "HTML", 907, 0, 0, 0, 0, 147, 249, 1303
"c:\xampp_new\htdocs\www\index-11.html", "HTML", 891, 0, 0, 0, 0, 139, 246, 1276
"c:\xampp_new\htdocs\www\index-12.html", "HTML", 890, 0, 0, 0, 0, 137, 245, 1272
"c:\xampp_new\htdocs\www\index-13.html", "HTML", 894, 0, 0, 0, 0, 139, 247, 1280
"c:\xampp_new\htdocs\www\index-14.html", "HTML", 894, 0, 0, 0, 0, 139, 246, 1279
"c:\xampp_new\htdocs\www\index-15.html", "HTML", 901, 0, 0, 0, 0, 141, 247, 1289
"c:\xampp_new\htdocs\www\index-16.html", "HTML", 863, 0, 0, 0, 0, 133, 237, 1233
"c:\xampp_new\htdocs\www\index-17.html", "HTML", 1103, 0, 0, 0, 0, 143, 333, 1579
"c:\xampp_new\htdocs\www\index-18.html", "HTML", 1103, 0, 0, 0, 0, 143, 333, 1579
"c:\xampp_new\htdocs\www\index-19.html", "HTML", 902, 0, 0, 0, 0, 142, 248, 1292
"c:\xampp_new\htdocs\www\index-20.html", "HTML", 918, 0, 0, 0, 0, 149, 263, 1330
"c:\xampp_new\htdocs\www\index.html", "HTML", 888, 0, 0, 0, 0, 140, 244, 1272
"c:\xampp_new\htdocs\www\intro.html", "HTML", 1516, 0, 0, 0, 0, 243, 447, 2206
"c:\xampp_new\htdocs\www\js\SmoothScroll.js", "JavaScript", 0, 0, 0, 1, 0, 0, 0, 1
"c:\xampp_new\htdocs\www\js\all.js", "JavaScript", 0, 0, 0, 1248, 0, 197, 312, 1757
"c:\xampp_new\htdocs\www\js\bootstrap.bundle.min.js", "JavaScript", 0, 0, 0, 1, 0, 6, 0, 7
"c:\xampp_new\htdocs\www\js\bootstrap.min.js", "JavaScript", 0, 0, 0, 1, 0, 8, 2, 11
"c:\xampp_new\htdocs\www\js\contact-form.js", "JavaScript", 0, 0, 0, 43, 0, 12, 14, 69
"c:\xampp_new\htdocs\www\js\contact-reservations-form.js", "JavaScript", 0, 0, 0, 43, 0, 12, 13, 68
"c:\xampp_new\htdocs\www\js\imagesloaded.pkgd.min.js", "JavaScript", 0, 0, 0, 1, 0, 5, 1, 7
"c:\xampp_new\htdocs\www\js\isotope.pkgd.min.js", "JavaScript", 0, 0, 0, 2, 0, 9, 1, 12
"c:\xampp_new\htdocs\www\js\jquery-1.11.2.min.js", "JavaScript", 0, 0, 0, 3, 0, 1, 1, 5
"c:\xampp_new\htdocs\www\js\jquery-3.5.1.min.js", "JavaScript", 0, 0, 0, 1, 0, 1, 1, 3
"c:\xampp_new\htdocs\www\js\jquery-migrate-1.4.1.min.js", "JavaScript", 0, 0, 0, 1, 0, 1, 0, 2
"c:\xampp_new\htdocs\www\js\jquery.ajaxchimp.min.js", "JavaScript", 0, 0, 0, 9, 0, 0, 4, 13
"c:\xampp_new\htdocs\www\js\jquery.appear.js", "JavaScript", 0, 0, 0, 1, 0, 9, 0, 10
"c:\xampp_new\htdocs\www\js\jquery.backgroundvideo.min.js", "JavaScript", 0, 0, 0, 34, 0, 8, 7, 49
"c:\xampp_new\htdocs\www\js\jquery.countTo.js", "JavaScript", 0, 0, 0, 1, 0, 0, 0, 1
"c:\xampp_new\htdocs\www\js\jquery.downCount.js", "JavaScript", 0, 0, 0, 68, 0, 27, 27, 122
"c:\xampp_new\htdocs\www\js\jquery.easing.1.3.js", "JavaScript", 0, 0, 0, 8, 0, 0, 0, 8
"c:\xampp_new\htdocs\www\js\jquery.fitvids.js", "JavaScript", 0, 0, 0, 60, 0, 11, 11, 82
"c:\xampp_new\htdocs\www\js\jquery.lazyload.min.js", "JavaScript", 0, 0, 0, 16, 0, 1, 1, 18
"c:\xampp_new\htdocs\www\js\jquery.localScroll.min.js", "JavaScript", 0, 0, 0, 1, 0, 6, 0, 7
"c:\xampp_new\htdocs\www\js\jquery.magnific-popup.min.js", "JavaScript", 0, 0, 0, 1, 0, 3, 0, 4
"c:\xampp_new\htdocs\www\js\jquery.mb.YTPlayer.js", "JavaScript", 0, 0, 0, 4, 0, 8, 3, 15
"c:\xampp_new\htdocs\www\js\jquery.parallax-1.1.3.js", "JavaScript", 0, 0, 0, 1, 0, 0, 0, 1
"c:\xampp_new\htdocs\www\js\jquery.scrollTo.min.js", "JavaScript", 0, 0, 0, 1, 0, 6, 0, 7
"c:\xampp_new\htdocs\www\js\jquery.simple-text-rotator.min.js", "JavaScript", 0, 0, 0, 15, 0, 1, 1, 17
"c:\xampp_new\htdocs\www\js\jquery.sticky.js", "JavaScript", 0, 0, 0, 181, 0, 15, 22, 218
"c:\xampp_new\htdocs\www\js\jquery.viewport.mini.js", "JavaScript", 0, 0, 0, 1, 0, 0, 1, 2
"c:\xampp_new\htdocs\www\js\masonry.pkgd.min.js", "JavaScript", 0, 0, 0, 1, 0, 7, 1, 9
"c:\xampp_new\htdocs\www\js\morphext.js", "JavaScript", 0, 0, 0, 15, 0, 0, 0, 15
"c:\xampp_new\htdocs\www\js\owl.carousel.min.js", "JavaScript", 0, 0, 0, 1, 0, 0, 0, 1
"c:\xampp_new\htdocs\www\js\placeholder.js", "JavaScript", 0, 0, 0, 99, 0, 13, 49, 161
"c:\xampp_new\htdocs\www\js\rev-slider.js", "JavaScript", 0, 0, 0, 113, 0, 1, 36, 150
"c:\xampp_new\htdocs\www\js\tiltfx.js", "JavaScript", 0, 0, 0, 169, 0, 52, 29, 250
"c:\xampp_new\htdocs\www\js\wow.min.js", "JavaScript", 0, 0, 0, 1, 0, 3, 1, 5
"c:\xampp_new\htdocs\www\mp-index-01.html", "HTML", 1611, 0, 0, 0, 0, 227, 350, 2188
"c:\xampp_new\htdocs\www\mp-index-02.html", "HTML", 1611, 0, 0, 0, 0, 227, 350, 2188
"c:\xampp_new\htdocs\www\mp-index-03.html", "HTML", 1615, 0, 0, 0, 0, 227, 351, 2193
"c:\xampp_new\htdocs\www\mp-index-04.html", "HTML", 1615, 0, 0, 0, 0, 227, 351, 2193
"c:\xampp_new\htdocs\www\mp-index-05.html", "HTML", 1619, 0, 0, 0, 0, 227, 351, 2197
"c:\xampp_new\htdocs\www\mp-index-06.html", "HTML", 1615, 0, 0, 0, 0, 227, 351, 2193
"c:\xampp_new\htdocs\www\mp-index-07.html", "HTML", 1650, 0, 0, 0, 0, 235, 366, 2251
"c:\xampp_new\htdocs\www\mp-index-08.html", "HTML", 1650, 0, 0, 0, 0, 235, 366, 2251
"c:\xampp_new\htdocs\www\mp-index-09.html", "HTML", 1650, 0, 0, 0, 0, 235, 366, 2251
"c:\xampp_new\htdocs\www\mp-index-10.html", "HTML", 1629, 0, 0, 0, 0, 235, 354, 2218
"c:\xampp_new\htdocs\www\mp-index-11.html", "HTML", 1613, 0, 0, 0, 0, 227, 351, 2191
"c:\xampp_new\htdocs\www\mp-index-12.html", "HTML", 1612, 0, 0, 0, 0, 225, 350, 2187
"c:\xampp_new\htdocs\www\mp-index-13.html", "HTML", 1616, 0, 0, 0, 0, 227, 353, 2196
"c:\xampp_new\htdocs\www\mp-index-14.html", "HTML", 1616, 0, 0, 0, 0, 227, 353, 2196
"c:\xampp_new\htdocs\www\mp-index-15.html", "HTML", 1623, 0, 0, 0, 0, 229, 354, 2206
"c:\xampp_new\htdocs\www\mp-index-16.html", "HTML", 1633, 0, 0, 0, 0, 229, 346, 2208
"c:\xampp_new\htdocs\www\mp-index-17.html", "HTML", 1826, 0, 0, 0, 0, 231, 438, 2495
"c:\xampp_new\htdocs\www\mp-index-18.html", "HTML", 1826, 0, 0, 0, 0, 231, 438, 2495
"c:\xampp_new\htdocs\www\mp-index-19.html", "HTML", 1624, 0, 0, 0, 0, 230, 354, 2208
"c:\xampp_new\htdocs\www\mp-index-20.html", "HTML", 1640, 0, 0, 0, 0, 237, 368, 2245
"c:\xampp_new\htdocs\www\mp-index.html", "HTML", 1610, 0, 0, 0, 0, 227, 350, 2187
"c:\xampp_new\htdocs\www\pages-404.html", "HTML", 117, 0, 0, 0, 0, 37, 37, 191
"c:\xampp_new\htdocs\www\pages-about-1.html", "HTML", 969, 0, 0, 0, 0, 124, 217, 1310
"c:\xampp_new\htdocs\www\pages-about-2.html", "HTML", 1070, 0, 0, 0, 0, 147, 251, 1468
"c:\xampp_new\htdocs\www\pages-about-3.html", "HTML", 1050, 0, 0, 0, 0, 147, 259, 1456
"c:\xampp_new\htdocs\www\pages-account.html", "HTML", 786, 0, 0, 0, 0, 92, 173, 1051
"c:\xampp_new\htdocs\www\pages-clients.html", "HTML", 959, 0, 0, 0, 0, 133, 184, 1276
"c:\xampp_new\htdocs\www\pages-contact-1.html", "HTML", 817, 0, 0, 0, 0, 91, 174, 1082
"c:\xampp_new\htdocs\www\pages-contact-2.html", "HTML", 810, 0, 0, 0, 0, 91, 170, 1071
"c:\xampp_new\htdocs\www\pages-faq-1.html", "HTML", 769, 0, 0, 0, 0, 78, 149, 996
"c:\xampp_new\htdocs\www\pages-faq-2.html", "HTML", 775, 0, 0, 0, 0, 80, 158, 1013
"c:\xampp_new\htdocs\www\pages-gallery-1col.html", "HTML", 739, 0, 0, 0, 0, 88, 144, 971
"c:\xampp_new\htdocs\www\pages-gallery-2col.html", "HTML", 763, 0, 0, 0, 0, 94, 164, 1021
"c:\xampp_new\htdocs\www\pages-gallery-3col.html", "HTML", 783, 0, 0, 0, 0, 102, 176, 1061
"c:\xampp_new\htdocs\www\pages-gallery-4col.html", "HTML", 803, 0, 0, 0, 0, 110, 188, 1101
"c:\xampp_new\htdocs\www\pages-gallery-6col.html", "HTML", 803, 0, 0, 0, 0, 110, 188, 1101
"c:\xampp_new\htdocs\www\pages-landing.html", "HTML", 969, 0, 0, 0, 0, 130, 222, 1321
"c:\xampp_new\htdocs\www\pages-pricing-1.html", "HTML", 849, 0, 0, 0, 0, 98, 182, 1129
"c:\xampp_new\htdocs\www\pages-pricing-2.html", "HTML", 880, 0, 0, 0, 0, 104, 192, 1176
"c:\xampp_new\htdocs\www\pages-services-1.html", "HTML", 970, 0, 0, 0, 0, 102, 185, 1257
"c:\xampp_new\htdocs\www\pages-services-2.html", "HTML", 864, 0, 0, 0, 0, 96, 166, 1126
"c:\xampp_new\htdocs\www\pages-services-3.html", "HTML", 859, 0, 0, 0, 0, 100, 183, 1142
"c:\xampp_new\htdocs\www\pages-team-1.html", "HTML", 870, 0, 0, 0, 0, 96, 198, 1164
"c:\xampp_new\htdocs\www\pages-team-2.html", "HTML", 896, 0, 0, 0, 0, 98, 211, 1205
"c:\xampp_new\htdocs\www\pages-under-construction.html", "HTML", 117, 0, 0, 0, 0, 37, 37, 191
"c:\xampp_new\htdocs\www\php\PHPMailer.php", "PHP", 0, 2745, 0, 0, 0, 1836, 370, 4951
"c:\xampp_new\htdocs\www\php\SMTP.php", "PHP", 0, 718, 0, 0, 0, 598, 141, 1457
"c:\xampp_new\htdocs\www\portfolio-boxed-2col.html", "HTML", 817, 0, 0, 0, 0, 94, 151, 1062
"c:\xampp_new\htdocs\www\portfolio-boxed-3col.html", "HTML", 895, 0, 0, 0, 0, 106, 157, 1158
"c:\xampp_new\htdocs\www\portfolio-boxed-4col.html", "HTML", 947, 0, 0, 0, 0, 114, 161, 1222
"c:\xampp_new\htdocs\www\portfolio-boxed-5col.html", "HTML", 934, 0, 0, 0, 0, 112, 160, 1206
"c:\xampp_new\htdocs\www\portfolio-boxed-blackhover.html", "HTML", 947, 0, 0, 0, 0, 114, 161, 1222
"c:\xampp_new\htdocs\www\portfolio-boxed-gutter-2col.html", "HTML", 817, 0, 0, 0, 0, 94, 151, 1062
"c:\xampp_new\htdocs\www\portfolio-boxed-gutter-3col.html", "HTML", 895, 0, 0, 0, 0, 106, 157, 1158
"c:\xampp_new\htdocs\www\portfolio-boxed-gutter-4col.html", "HTML", 947, 0, 0, 0, 0, 114, 161, 1222
"c:\xampp_new\htdocs\www\portfolio-boxed-gutter-5col.html", "HTML", 934, 0, 0, 0, 0, 112, 160, 1206
"c:\xampp_new\htdocs\www\portfolio-boxed-gutter-blackhover.html", "HTML", 947, 0, 0, 0, 0, 114, 161, 1222
"c:\xampp_new\htdocs\www\portfolio-boxed-titles-2col.html", "HTML", 817, 0, 0, 0, 0, 94, 151, 1062
"c:\xampp_new\htdocs\www\portfolio-boxed-titles-3col.html", "HTML", 895, 0, 0, 0, 0, 106, 157, 1158
"c:\xampp_new\htdocs\www\portfolio-boxed-titles-4col.html", "HTML", 947, 0, 0, 0, 0, 114, 161, 1222
"c:\xampp_new\htdocs\www\portfolio-boxed-titles-5col.html", "HTML", 934, 0, 0, 0, 0, 112, 160, 1206
"c:\xampp_new\htdocs\www\portfolio-boxed-titles-blackhover.html", "HTML", 947, 0, 0, 0, 0, 114, 161, 1222
"c:\xampp_new\htdocs\www\portfolio-lazyload.html", "HTML", 895, 0, 0, 0, 0, 106, 156, 1157
"c:\xampp_new\htdocs\www\portfolio-masonry-2col.html", "HTML", 817, 0, 0, 0, 0, 94, 151, 1062
"c:\xampp_new\htdocs\www\portfolio-masonry-3col.html", "HTML", 817, 0, 0, 0, 0, 94, 151, 1062
"c:\xampp_new\htdocs\www\portfolio-masonry-4col.html", "HTML", 856, 0, 0, 0, 0, 100, 154, 1110
"c:\xampp_new\htdocs\www\portfolio-masonry-5col.html", "HTML", 895, 0, 0, 0, 0, 106, 157, 1158
"c:\xampp_new\htdocs\www\portfolio-masonry-blackhover.html", "HTML", 856, 0, 0, 0, 0, 100, 154, 1110
"c:\xampp_new\htdocs\www\portfolio-parallax.html", "HTML", 783, 0, 0, 0, 0, 84, 168, 1035
"c:\xampp_new\htdocs\www\portfolio-promo.html", "HTML", 886, 0, 0, 0, 0, 118, 216, 1220
"c:\xampp_new\htdocs\www\portfolio-single-1.html", "HTML", 901, 0, 0, 0, 0, 119, 184, 1204
"c:\xampp_new\htdocs\www\portfolio-single-2.html", "HTML", 846, 0, 0, 0, 0, 104, 173, 1123
"c:\xampp_new\htdocs\www\portfolio-single-3.html", "HTML", 972, 0, 0, 0, 0, 142, 206, 1320
"c:\xampp_new\htdocs\www\portfolio-single-4.html", "HTML", 808, 0, 0, 0, 0, 98, 174, 1080
"c:\xampp_new\htdocs\www\portfolio-single-5.html", "HTML", 788, 0, 0, 0, 0, 100, 168, 1056
"c:\xampp_new\htdocs\www\portfolio-wide-2col.html", "HTML", 817, 0, 0, 0, 0, 94, 151, 1062
"c:\xampp_new\htdocs\www\portfolio-wide-3col.html", "HTML", 817, 0, 0, 0, 0, 94, 151, 1062
"c:\xampp_new\htdocs\www\portfolio-wide-4col.html", "HTML", 843, 0, 0, 0, 0, 98, 153, 1094
"c:\xampp_new\htdocs\www\portfolio-wide-5col.html", "HTML", 869, 0, 0, 0, 0, 102, 155, 1126
"c:\xampp_new\htdocs\www\portfolio-wide-blackhover.html", "HTML", 843, 0, 0, 0, 0, 98, 153, 1094
"c:\xampp_new\htdocs\www\portfolio-wide-gutter-2col.html", "HTML", 817, 0, 0, 0, 0, 94, 151, 1062
"c:\xampp_new\htdocs\www\portfolio-wide-gutter-3col.html", "HTML", 817, 0, 0, 0, 0, 94, 151, 1062
"c:\xampp_new\htdocs\www\portfolio-wide-gutter-4col.html", "HTML", 843, 0, 0, 0, 0, 98, 153, 1094
"c:\xampp_new\htdocs\www\portfolio-wide-gutter-5col.html", "HTML", 869, 0, 0, 0, 0, 102, 155, 1126
"c:\xampp_new\htdocs\www\portfolio-wide-gutter-blackhover.html", "HTML", 843, 0, 0, 0, 0, 98, 153, 1094
"c:\xampp_new\htdocs\www\portfolio-wide-titles-2col.html", "HTML", 817, 0, 0, 0, 0, 94, 151, 1062
"c:\xampp_new\htdocs\www\portfolio-wide-titles-3col.html", "HTML", 817, 0, 0, 0, 0, 94, 151, 1062
"c:\xampp_new\htdocs\www\portfolio-wide-titles-4col.html", "HTML", 843, 0, 0, 0, 0, 98, 153, 1094
"c:\xampp_new\htdocs\www\portfolio-wide-titles-5col.html", "HTML", 869, 0, 0, 0, 0, 102, 155, 1126
"c:\xampp_new\htdocs\www\portfolio-wide-titles-blackhover.html", "HTML", 843, 0, 0, 0, 0, 98, 153, 1094
"c:\xampp_new\htdocs\www\rs-plugin\css\settings-ie8.css", "CSS", 0, 0, 0, 0, 531, 83, 180, 794
"c:\xampp_new\htdocs\www\rs-plugin\css\settings.css", "CSS", 0, 0, 0, 0, 1742, 141, 462, 2345
"c:\xampp_new\htdocs\www\rs-plugin\font\revicons.svg", "XML", 0, 0, 54, 0, 0, 0, 0, 54
"c:\xampp_new\htdocs\www\rs-plugin\js\jquery.themepunch.plugins.min.js", "JavaScript", 0, 0, 0, 8, 0, 66, 16, 90
"c:\xampp_new\htdocs\www\rs-plugin\js\jquery.themepunch.revolution.js", "JavaScript", 0, 0, 0, 4088, 0, 542, 1599, 6229
"c:\xampp_new\htdocs\www\rs-plugin\js\jquery.themepunch.revolution.min.js", "JavaScript", 0, 0, 0, 1, 0, 6, 2, 9
"c:\xampp_new\htdocs\www\rs-plugin\js\jquery.themepunch.tools.min.js", "JavaScript", 0, 0, 0, 40, 0, 73, 30, 143
"c:\xampp_new\htdocs\www\shop-cart.html", "HTML", 830, 0, 0, 0, 0, 76, 162, 1068
"c:\xampp_new\htdocs\www\shop-columns-2col.html", "HTML", 1104, 0, 0, 0, 0, 128, 259, 1491
"c:\xampp_new\htdocs\www\shop-columns-3col.html", "HTML", 1071, 0, 0, 0, 0, 124, 250, 1445
"c:\xampp_new\htdocs\www\shop-columns-4col.html", "HTML", 1121, 0, 0, 0, 0, 132, 288, 1541
"c:\xampp_new\htdocs\www\shop-single.html", "HTML", 1021, 0, 0, 0, 0, 121, 226, 1368
"c:\xampp_new\htdocs\www\special-barbershop-about.html", "HTML", 211, 0, 0, 0, 0, 49, 57, 317
"c:\xampp_new\htdocs\www\special-barbershop-contact.html", "HTML", 260, 0, 0, 0, 0, 62, 78, 400
"c:\xampp_new\htdocs\www\special-barbershop-gallery.html", "HTML", 220, 0, 0, 0, 0, 63, 71, 354
"c:\xampp_new\htdocs\www\special-barbershop-pricing.html", "HTML", 491, 0, 0, 0, 0, 49, 57, 597
"c:\xampp_new\htdocs\www\special-barbershop.html", "HTML", 442, 0, 0, 0, 0, 111, 111, 664
"c:\xampp_new\htdocs\www\special-coming-soon-1.html", "HTML", 343, 0, 0, 0, 0, 79, 104, 526
"c:\xampp_new\htdocs\www\special-coming-soon-2.html", "HTML", 338, 0, 0, 0, 0, 81, 110, 529
"c:\xampp_new\htdocs\www\special-construction-1-about.html", "HTML", 473, 0, 0, 0, 0, 98, 165, 736
"c:\xampp_new\htdocs\www\special-construction-1-contact.html", "HTML", 359, 0, 0, 0, 0, 87, 113, 559
"c:\xampp_new\htdocs\www\special-construction-1-portfolio.html", "HTML", 349, 0, 0, 0, 0, 88, 125, 562
"c:\xampp_new\htdocs\www\special-construction-1-services-single.html", "HTML", 364, 0, 0, 0, 0, 90, 114, 568
"c:\xampp_new\htdocs\www\special-construction-1-services.html", "HTML", 396, 0, 0, 0, 0, 95, 131, 622
"c:\xampp_new\htdocs\www\special-construction-1.html", "HTML", 693, 0, 0, 0, 0, 164, 227, 1084
"c:\xampp_new\htdocs\www\special-construction-2-about.html", "HTML", 464, 0, 0, 0, 0, 91, 158, 713
"c:\xampp_new\htdocs\www\special-construction-2-contact.html", "HTML", 350, 0, 0, 0, 0, 80, 104, 534
"c:\xampp_new\htdocs\www\special-construction-2-portfolio.html", "HTML", 340, 0, 0, 0, 0, 81, 118, 539
"c:\xampp_new\htdocs\www\special-construction-2-services-single.html", "HTML", 355, 0, 0, 0, 0, 83, 107, 545
"c:\xampp_new\htdocs\www\special-construction-2-services.html", "HTML", 388, 0, 0, 0, 0, 88, 124, 600
"c:\xampp_new\htdocs\www\special-construction-2.html", "HTML", 684, 0, 0, 0, 0, 157, 220, 1061
"c:\xampp_new\htdocs\www\special-construction-3-about.html", "HTML", 468, 0, 0, 0, 0, 96, 163, 727
"c:\xampp_new\htdocs\www\special-construction-3-contact.html", "HTML", 354, 0, 0, 0, 0, 85, 109, 548
"c:\xampp_new\htdocs\www\special-construction-3-portfolio.html", "HTML", 344, 0, 0, 0, 0, 86, 123, 553
"c:\xampp_new\htdocs\www\special-construction-3-services-single.html", "HTML", 359, 0, 0, 0, 0, 88, 112, 559
"c:\xampp_new\htdocs\www\special-construction-3-services.html", "HTML", 392, 0, 0, 0, 0, 93, 129, 614
"c:\xampp_new\htdocs\www\special-construction-3.html", "HTML", 688, 0, 0, 0, 0, 162, 225, 1075
"c:\xampp_new\htdocs\www\special-cv-resume.html", "HTML", 477, 0, 0, 0, 0, 100, 149, 726
"c:\xampp_new\htdocs\www\special-fashion.html", "HTML", 1425, 0, 0, 0, 0, 190, 355, 1970
"c:\xampp_new\htdocs\www\special-finance-1.html", "HTML", 589, 0, 0, 0, 0, 115, 185, 889
"c:\xampp_new\htdocs\www\special-finance-2-about.html", "HTML", 324, 0, 0, 0, 0, 72, 91, 487
"c:\xampp_new\htdocs\www\special-finance-2-contact.html", "HTML", 290, 0, 0, 0, 0, 65, 97, 452
"c:\xampp_new\htdocs\www\special-finance-2-expertise.html", "HTML", 263, 0, 0, 0, 0, 58, 78, 399
"c:\xampp_new\htdocs\www\special-finance-2-portfolio.html", "HTML", 280, 0, 0, 0, 0, 62, 98, 440
"c:\xampp_new\htdocs\www\special-finance-2-qa.html", "HTML", 241, 0, 0, 0, 0, 52, 74, 367
"c:\xampp_new\htdocs\www\special-finance-2.html", "HTML", 412, 0, 0, 0, 0, 82, 127, 621
"c:\xampp_new\htdocs\www\special-landing-1.html", "HTML", 400, 0, 0, 0, 0, 93, 123, 616
"c:\xampp_new\htdocs\www\special-landing-2.html", "HTML", 504, 0, 0, 0, 0, 130, 179, 813
"c:\xampp_new\htdocs\www\special-magazine-1.html", "HTML", 1244, 0, 0, 0, 0, 143, 317, 1704
"c:\xampp_new\htdocs\www\special-magazine-2.html", "HTML", 1293, 0, 0, 0, 0, 157, 327, 1777
"c:\xampp_new\htdocs\www\special-photographer-1-about.html", "HTML", 270, 0, 0, 0, 0, 60, 94, 424
"c:\xampp_new\htdocs\www\special-photographer-1-contact.html", "HTML", 228, 0, 0, 0, 0, 57, 81, 366
"c:\xampp_new\htdocs\www\special-photographer-1-portfolio.html", "HTML", 290, 0, 0, 0, 0, 66, 69, 425
"c:\xampp_new\htdocs\www\special-photographer-1.html", "HTML", 294, 0, 0, 0, 0, 95, 83, 472
"c:\xampp_new\htdocs\www\special-photographer-2-about.html", "HTML", 207, 0, 0, 0, 0, 58, 77, 342
"c:\xampp_new\htdocs\www\special-photographer-2-contact.html", "HTML", 226, 0, 0, 0, 0, 65, 82, 373
"c:\xampp_new\htdocs\www\special-photographer-2-portfolio.html", "HTML", 277, 0, 0, 0, 0, 72, 67, 416
"c:\xampp_new\htdocs\www\special-photographer-2.html", "HTML", 290, 0, 0, 0, 0, 68, 72, 430
"c:\xampp_new\htdocs\www\special-photographer-3-about.html", "HTML", 207, 0, 0, 0, 0, 58, 77, 342
"c:\xampp_new\htdocs\www\special-photographer-3-contact.html", "HTML", 226, 0, 0, 0, 0, 65, 82, 373
"c:\xampp_new\htdocs\www\special-photographer-3-portfolio.html", "HTML", 277, 0, 0, 0, 0, 72, 67, 416
"c:\xampp_new\htdocs\www\special-photographer-3.html", "HTML", 290, 0, 0, 0, 0, 68, 72, 430
"c:\xampp_new\htdocs\www\special-product-designer-about.html", "HTML", 302, 0, 0, 0, 0, 67, 82, 451
"c:\xampp_new\htdocs\www\special-product-designer-contact.html", "HTML", 188, 0, 0, 0, 0, 50, 41, 279
"c:\xampp_new\htdocs\www\special-product-designer.html", "HTML", 162, 0, 0, 0, 0, 47, 39, 248
"c:\xampp_new\htdocs\www\special-restaurant-1.html", "HTML", 601, 0, 0, 0, 0, 87, 160, 848
"c:\xampp_new\htdocs\www\special-restaurant-2-about.html", "HTML", 254, 0, 0, 0, 0, 61, 62, 377
"c:\xampp_new\htdocs\www\special-restaurant-2-gallery.html", "HTML", 218, 0, 0, 0, 0, 65, 74, 357
"c:\xampp_new\htdocs\www\special-restaurant-2-location.html", "HTML", 190, 0, 0, 0, 0, 49, 52, 291
"c:\xampp_new\htdocs\www\special-restaurant-2-menu.html", "HTML", 469, 0, 0, 0, 0, 58, 106, 633
"c:\xampp_new\htdocs\www\special-restaurant-2-reservations.html", "HTML", 226, 0, 0, 0, 0, 54, 69, 349
"c:\xampp_new\htdocs\www\special-restaurant-2.html", "HTML", 291, 0, 0, 0, 0, 78, 76, 445
"Total", "-", 171429, 3698, 3939, 6283, 9769, 28085, 43323, 266526